,,,,#########,,,,,,,,,,,,,,,,,,,,###############
,,,,#.......#,,,,,,,,,,,,,,,,,,,,#.............#
,,,,........######################.............#
,,,,...........................................#
,,,,#...@......................................#
,,,,#..........................................#
,,,,#.......######################.............#
,,,,#.......#,,,,,,,,,,,,,,,,,,,,#.............#
,,,,#########,,,,,,,,,,,,,,,,,,,,###############
