...###...................###........
..##....######..........##....######
.##....###....#.......##....###....#
##.............#....##.............#
#...@..#.......#....#......#.......#
###..###....*..##....##..###....*..#
..#..#.........#......#..#.........#
.##...##...#...##....##...##...#...##
.#........######.....#........######
.#......##...........#......##
.#######.............#######
...###..................###
...###...................###........
..##....######..........##....######
.##....###....#.......##....###....#
##.............#....##.............#
#...@..#.......#....#......#.......#
###..###....*..##....##..###....*..#
..#..#.........#......#..#.........#
.##...##...#...##....##...##...#...##
.#........######.....#........######
.#......##...........#......##
.#######.............#######
...###..................###
...###...................###........
..##....######..........##....######
.##....###....#.......##....###....#
##.............#....##.............#
#...@..#.......#....#......#.......#
###..###....*..##....##..###....*..#
..#..#.........#......#..#.........#
.##...##...#...##....##...##...#...##
.#........######.....#........######
.#......##...........#......##
.#######.............#######
...###..................###
...###...................###........
..##....######..........##....######
.##....###....#.......##....###....#
##.............#....##.............#
#...@..#.......#....#......#.......#
###..###....*..##....##..###....*..#
..#..#.........#......#..#.........#
.##...##...#...##....##...##...#...##
.#........######.....#........######
.#......##...........#......##
.#######.............#######
...###..................###
...###...................###........
..##....######..........##....######
.##....###....#.......##....###....#
##.............#....##.............#
#...@..#.......#....#......#.......#
###..###....*..##....##..###....*..#
..#..#.........#......#..#.........#
.##...##...#...##....##...##...#...##
.#........######.....#........######
.#......##...........#......##
.#######.............#######
...###..................###

