#######################################
#........................H.h..........#
#........................M.m......*...#
#........@...............D.d..........#
#........................S.s..........#
#.....................................#
#######################################