################
#..............#
#..............#
#..............#
#........@.....#
#..............#
#..............#
