#######################################
#........................R............#
#........................P........*...#
#........@...............G............#
#.....................................#
#######################################