#######################################
#.....................................#
#.....................................#
#............................C........#
#........@............................#
#.....................................#
#.....................................#
#.....................................#
#....................C................#
#.....................................#
#........C........................*...#
#.....................................#
#######################################